abap : abap
abc : abc
as|actionscript : actionscript
ada|adb : ada
apache_conf|^htaccess|^htgroups|^htpasswd|^conf|htaccess|htgroups|htpasswd : apache_conf
applescript : applescript
asciidoc : asciidoc
assembly_x86|asm : assembly_x86
autohotkey|ahk : autohotkey
batchfile|bat|cmd : batchfile
c9search|c9search_results : c9search
c_cpp|cpp|c|cc|cxx|h|hh|hpp : c_cpp
cirru|cr : cirru
clojure|clj|cljs : clojure
cobol|CBL|COB : cobol
coffee|coffeescript|cf|cson|^Cakefile : coffee
coldfusion|cfm : coldfusion
cs|csharp : csharp
css : css
curly : curly
d|di : d
dart : dart
diff|patch : diff
django : django
dockerfile : dockerfile
dot : dot
eiffel|e : eiffel
ejs : ejs
elixir : elixir
elm : elm
erlang|erl|hrl : erlang
forth|frt|fs|ldr : forth
ftl : ftl
gcode : gcode
gherkin|feature : gherkin
gitignore|^.gitignore : gitignore
glsl|frag|vert : glsl
golang|go : golang
groovy : groovy
haml : haml
hbs|handlebars|tpl|mustache : handlebars
haskell|hs : haskell
haxe|hx : haxe
html|htm|xhtml : html
html_ruby|erb|rhtml|html.erb : html_ruby
ini|conf|cfg|prefs : ini
io : io
jack : jack
jade : jade
java : java
javascript|js|jsm : javascript
json : json
jsoniq|jq : jsoniq
jsp : jsp
jsx : jsx
julia|jl : julia
tex|latex|ltx|bib : latex
lean : lean
less : less
liquid : liquid
common_lisp|lisp : lisp
livescript|ls : livescript
logicql|logic|lql : logicql
lsl : lsl
lua : lua
lp|luapage : luapage
lucene : lucene
Makefile|GNUmakefile|makefile|OCamlMakefile|make : makefile
md|markdown : markdown
mask : mask
matlab : matlab
maze : maze
mel : mel
mipsassembler : mipsassembler
mips_assembler : mips_assembler
mushcode|mc|mush : mushcode
mysql : mysql
nix : nix
objectivec|objective_c|m|mm : objectivec
ocaml|ml|mli : ocaml
pascal|delphi|pas|p : pascal
perl|pl|pm : perl
pgsql : pgsql
php|phtml : php
plain_text : plain_text
powershell|ps1 : powershell
praat : praat
plg|prolog : prolog
properties : properties
protobuf|proto : protobuf
py|python : python
r : r
rd|rdoc : rdoc
rhtml : rhtml
rb|ruby|gemspec|rake|^Guardfile|^Rakefile|^Gemfile : ruby
rs|rust : rust
sass : sass
scad : scad
scala : scala
scheme|scm|rkt : scheme
scss : scss
sh|bash|^.bashrc : sh
sjs : sjs
smarty|tpl : smarty
snippets : snippets
soy|soy_template : soy_template
space : space
sql : sql
mssql|sqlserver : sqlserver
styl|stylus : stylus
svg : svg
tcl : tcl
tex : tex
txt|text : text
textile : textile
toml : toml
twig : twig
ts|typescript|str : typescript
vala : vala
vbs|vbscript|vb|visualbasic|vb.net|vba|vbnet : vbscript
vm|velocity : velocity
v|vh|sv|svh|verilog : verilog
vhd|vhdl : vhdl
xml|rdf|rss|wsdl|xslt|atom|mathml|mml|xul|xbl : xml
xq|xquery : xquery
yaml|yml : yaml
